14	9	16	16	29	1	29	50	126
0	0	0	1	2	3	2	4	2	5	2	3	0	0	
0	0	0	6	0	0	0	6	0	0	0	6	0	0	
2	7	2	8	0	0	0	9	2	10	2	11	0	0	
0	0	0	12	0	0	0	6	0	0	0	0	0	0	
0	0	0	9	2	13	2	14	0	0	15	16	17	0	
0	18	18	6	18	0	0	0	15	16	19	20	21	0	
18	18	22	9	22	11	2	3	23	3	2	24	25	0	
18	22	22	6	22	22	18	6	25	18	18	18	25	0	
18	22	22	26	2	3	2	27	28	16	16	16	19	0	
